P........R
R...R...R.
RR.......Z
..........
..........
..........
..........
..........
..........
..........