FFFFFFFFFFFFFFF
FFFFFFFFFFFFFFF
FFFFFFFFFFFFFFF
FFFFFFFFFFFFFFF
FFFF.R...R.FFFF
FFFF.......FFFF
FFFF.......FFFF
FFFF.......FFFF
FFFF.......FFFF
FFFF.......FFFF
FFFF...P...FFFF
FFFFFFFFFFFFFFF
FFFFFFFFFFFFFFF
FFFFFFFFFFFFFFF
FFFFFFFEFFFFFFF

playerSpeed=2.5
robotSpeed=0.75
randomPill=150
durationPill=5000
playerInvincible=5000
robotInvincible=10000
factorRobotSpeed=10