FFFFFFFFFFFFFFF
FFFFFFFFFFFFFFF
FFFFFFFFFFFFFFF
FFFFFFFFFFFFFFF
FFFFR..R..RFFFF
FFFF.......FFFF
FFFF.......FFFF
FFFF.......FFFF
FFFF.......FFFF
FFFF.......FFFF
FFFF...P...FFFF
FFFFFFFFFFFFFFF
FFFFFFFFFFFFFFF
FFFFFFFFFFFFFFF
FFFFFFFEFFFFFFF

playerSpeed=2.5
robotSpeed=0.75
randomPill=300
durationPill=15000
playerInvincible=5000
robotInvincible=10000
factorRobotSpeed=10