...............
...............
...FFFFFFFFFF..
...F........F..
...F........F..
...F..FFFF..F..
.P.F..FE.F..F..
...F..F..F..F..
...F..F..F..F..
RRRF..F..F..F..
RRRF..F.....F..
RRRF..F.....F..
RRRF..FFFFFFF..
RRRF...........
RRRF...........