................
................
....FFFFFFFFF...
.P.F.........F..
...F.........F..
...F...FFF...F..
RRRF..F.E.F..F..
RRRF..F...F..F..
RRRF..F...F..F..
RRRF..F...F..F..
RRRF..F...F..F..
RRRF..F......F..
RRRF..F......F..
RRRF...FFFFFF...
RRRF............
RRRF............

playerSpeed=2.5
robotSpeed=1.75
randomPill=10
durationPill=15000
playerInvincible=5000
robotInvincible=10000