FFFFFFFFFFFFFF
.............F
...FFFFFFF...F
...F....EF...F
.P.F.....F...F
...F.....F...F
...F.....F...F
...F.....F...F
...F.....F...F
...F.....F...F
RRRF.....F...F
RRRF.....F...F
RRRF.........F
FFFFFFFFFFFFFF
player=2.5
robot=1.5
tunnel=5